grass
2 coin;4 plus_flame;1 clock;2 shoe;2 plus_bomb;2 shield
10,2
1 1 1 1 1 1 1 1 1 1 1 1 1 1 1 1
1 2 0 0 2 1 2 0 0 2 1 2 0 0 2 1
1 0 0 0 0 2 0 0 0 0 2 0 0 0 0 1
1 2 0 0 2 1 2 0 0 2 1 2 0 0 2 1
1 1 2 2 1 1 1 2 2 1 1 1 2 2 1 1
1 2 0 0 2 0 0 0 0 0 0 2 0 0 2 1
1 2 0 0 2 0 0 0 0 0 0 2 0 0 2 1
1 1 2 2 1 1 1 2 2 1 1 1 2 2 1 1
1 2 0 0 2 1 2 0 0 2 1 2 0 0 2 1
1 0 0 0 0 2 0 0 0 0 2 0 0 0 0 1
1 2 0 0 2 1 2 0 0 2 1 2 0 0 2 1
1 1 1 1 1 1 1 1 1 1 1 1 1 1 1 1