grass_2
3 shield;2 plus_bomb;3 clock;1 plus_flame;2 shoe;1 heart;4 coin
0 shield;1 plus_bomb;2 clock;1 plus_flame;2 shoe;4 heart;1 coin
2,14;3,7;6,2;6,6;7,10;8,3;8,12;9,7;9,9;10,13
6
1,1
1 1 1 1 1 1 1 1 1 1 1 1 1 1 1 1 
1 0 0 2 0 0 1 0 0 2 2 0 2 0 2 1 
1 0 0 1 2 2 1 2 1 0 1 0 0 0 0 1 
1 2 2 0 2 2 0 0 0 2 0 0 0 2 1 1 
1 0 1 0 2 1 2 2 2 2 1 2 2 2 2 1 
1 1 1 2 0 0 0 0 1 2 2 1 2 0 2 1 
1 2 0 1 0 2 0 0 2 2 2 0 0 1 2 1 
1 0 0 2 0 2 0 0 2 0 0 2 2 1 0 1 
1 1 0 0 0 0 0 2 1 0 0 0 0 1 0 1 
1 0 0 2 2 0 2 0 1 0 2 0 0 0 0 1 
1 2 2 0 2 0 0 0 0 2 0 2 1 0 0 1 
1 1 1 1 1 1 1 1 1 1 1 1 1 1 1 1 