grass_2
1 shield;2 plus_bomb;1 clock;2 plus_flame;3 shoe;4 heart;2 coin
2 shield;2 plus_bomb;0 clock;1 plus_flame;2 shoe;2 heart;3 coin
7,5;7,14;8,5;8,12;10,3
3
1,1
1 1 1 1 1 1 1 1 1 1 1 1 1 1 1 1 
1 0 0 1 1 2 0 0 0 2 2 0 0 0 0 1 
1 0 1 2 1 2 0 2 0 0 2 0 1 2 2 1 
1 0 1 2 0 0 0 1 0 1 2 2 0 2 0 1 
1 2 2 1 2 1 0 0 0 1 2 0 2 0 2 1 
1 0 2 2 2 0 2 1 0 0 2 1 0 2 0 1 
1 2 2 0 1 2 0 0 2 0 2 1 0 2 0 1 
1 1 0 2 2 0 2 2 2 1 1 0 0 2 0 1 
1 0 0 2 2 0 1 0 0 2 2 0 0 2 0 1 
1 0 0 0 1 2 2 2 0 0 0 2 0 2 2 1 
1 0 0 0 0 1 2 0 1 0 2 2 0 0 0 1 
1 1 1 1 1 1 1 1 1 1 1 1 1 1 1 1 