grass_2
null3 shield;1 plus_bomb;2 clock;1 plus_flame;2 shoe;3 heart;4 coin
3,13;4,13;5,2;7,5;8,1;9,5;10,11
1,1
1 1 1 1 1 1 1 1 1 1 1 1 1 1 1 1 
1 0 0 0 0 1 1 2 2 0 0 0 2 2 1 1 
1 2 2 2 2 2 1 0 2 0 2 0 0 2 2 1 
1 1 1 0 2 0 2 1 0 2 2 2 2 0 2 1 
1 2 0 1 0 0 1 0 2 0 0 2 1 0 0 1 
1 2 0 2 2 1 1 1 1 1 1 1 2 0 1 1 
1 1 0 2 0 0 0 0 0 2 1 2 0 0 0 1 
1 2 0 0 0 0 2 2 0 0 2 2 1 0 0 1 
1 0 0 1 0 0 1 0 1 2 1 2 0 0 2 1 
1 0 2 2 2 0 2 0 2 2 0 2 2 0 2 1 
1 2 1 2 2 0 2 0 2 0 0 0 0 0 2 1 
1 1 1 1 1 1 1 1 1 1 1 1 1 1 1 1 