grass_2
2 shield;3 plus_bomb;2 clock;1 plus_flame;2 shoe;3 heart;2 coin
2 shield;1 plus_bomb;1 clock;1 plus_flame;2 shoe;1 heart;2 coin
2,4;2,14;6,4;6,6;6,11;8,12;9,9;10,1;10,8;10,12
6
1,1
1 1 1 1 1 1 1 1 1 1 1 1 1 1 1 1 
1 0 2 1 2 0 1 0 1 1 2 2 0 0 2 1 
1 0 2 1 0 1 2 0 2 0 2 0 2 2 0 1 
1 0 0 1 2 1 2 1 0 0 0 0 2 2 2 1 
1 2 2 1 0 2 1 2 2 1 2 1 2 2 1 1 
1 0 2 2 0 2 1 0 0 0 2 1 2 0 0 1 
1 0 0 0 0 2 0 2 2 2 0 0 1 0 2 1 
1 0 2 2 1 0 0 0 2 0 2 0 0 0 1 1 
1 0 0 2 2 0 0 0 2 0 0 0 0 2 2 1 
1 0 0 2 0 0 1 0 0 0 2 0 0 0 0 1 
1 0 2 2 0 0 2 2 0 1 0 0 0 0 0 1 
1 1 1 1 1 1 1 1 1 1 1 1 1 1 1 1 