grass_2
0 shield;3 plus_bomb;3 clock;3 plus_flame;2 shoe;2 heart;2 coin
0 shield;3 plus_bomb;2 clock;2 plus_flame;1 shoe;3 heart;2 coin
1,6;2,3;3,13;6,10;7,1;7,6;9,2;9,5;9,11;9,12
6
1,1
1 1 1 1 1 1 1 1 1 1 1 1 1 1 1 1 
1 0 0 1 1 0 0 2 0 1 2 2 2 2 0 1 
1 0 1 0 0 0 1 1 2 0 0 1 2 2 0 1 
1 2 1 1 2 1 2 0 1 2 0 1 2 0 0 1 
1 2 2 2 2 2 0 2 2 1 0 2 2 1 0 1 
1 0 0 0 0 2 0 0 0 2 2 0 2 2 1 1 
1 0 0 0 0 2 0 1 0 2 0 2 0 0 0 1 
1 0 0 0 2 2 0 0 0 2 1 0 2 2 0 1 
1 2 0 1 0 2 0 2 2 2 0 2 2 1 0 1 
1 0 0 0 2 0 2 2 0 2 2 0 0 0 2 1 
1 0 0 2 2 0 0 0 0 0 0 0 0 2 0 1 
1 1 1 1 1 1 1 1 1 1 1 1 1 1 1 1 