grass
3 coin;3 plus_flame;1 clock;2 shoe;3 plus_bomb;1 shield
1,14;10,14;1,1;8,10
10,1
1 1 1 1 1 1 1 1 1 1 1 1 1 1 1 1
1 0 0 0 0 0 0 0 0 0 2 0 0 0 0 1
1 0 1 2 1 2 1 2 1 0 1 2 1 2 2 1
1 0 0 0 0 2 0 0 0 0 0 0 0 0 0 1
1 2 2 1 0 1 2 1 0 1 0 1 0 1 0 1
1 0 1 0 0 0 2 0 0 2 2 0 0 2 0 1
1 0 2 0 2 0 2 2 0 0 2 0 0 1 0 1
1 2 1 2 1 0 1 2 1 2 1 2 1 0 0 1
1 2 0 0 0 2 0 0 0 0 0 0 0 0 0 1
1 2 2 1 0 1 2 1 2 1 0 1 2 1 0 1
1 0 0 0 0 0 0 0 0 0 0 2 2 0 0 1
1 1 1 1 1 1 1 1 1 1 1 1 1 1 1 1