grass_2
3 shield;4 plus_bomb;3 clock;2 plus_flame;1 shoe;1 heart;1 coin
0 shield;0 plus_bomb;3 clock;2 plus_flame;3 shoe;1 heart;1 coin
1,8;3,13;6,8;6,13;7,1;9,9;9,14;10,2
4
1,1
1 1 1 1 1 1 1 1 1 1 1 1 1 1 1 1 
1 0 0 1 1 1 2 2 0 0 0 0 0 2 2 1 
1 0 1 0 0 2 0 2 2 0 1 1 0 0 2 1 
1 0 2 0 2 0 2 0 1 1 0 0 0 0 0 1 
1 2 1 0 0 2 2 0 1 2 2 0 1 1 2 1 
1 2 0 2 0 1 0 2 2 0 2 1 2 2 2 1 
1 2 2 0 0 2 0 0 0 2 2 1 0 0 0 1 
1 0 2 0 0 0 0 2 0 0 2 0 2 0 0 1 
1 0 2 2 2 2 2 2 2 0 0 2 2 0 2 1 
1 0 0 2 0 0 0 0 1 0 0 2 0 0 0 1 
1 2 0 0 0 0 0 2 2 2 0 2 0 2 0 1 
1 1 1 1 1 1 1 1 1 1 1 1 1 1 1 1 