grass
2 coin;3 plus_flame;1 clock;1 shoe;2 plus_bomb;1 shield
1,1
1 1 1 1 1 1 1 1 1 1 1 1 1 1 1 1
1 0 0 0 0 0 0 0 0 0 0 0 0 0 0 1
1 0 1 2 1 1 1 1 2 1 0 0 0 2 0 1
1 0 2 0 0 0 0 0 0 2 0 0 0 2 0 1
1 0 1 0 0 0 0 0 0 1 0 0 0 2 0 1
1 0 1 0 0 2 2 0 0 1 0 0 0 2 0 1
1 0 1 0 0 2 2 0 0 1 0 0 0 2 0 1
1 0 1 0 0 0 0 0 0 1 0 0 0 2 0 1
1 0 2 0 0 0 0 0 0 2 0 0 0 2 0 1
1 0 1 2 0 0 0 0 2 1 0 0 0 2 0 1
1 0 0 0 0 0 0 0 0 0 0 0 0 0 0 1
1 1 1 1 1 1 1 1 1 1 1 1 1 1 1 1