grass_2
4 coin;2 plus_flame;1 clock;1 shoe;2 plus_bomb;3 shield
1,14;10,1;10,14
1,1
1 1 1 1 1 1 1 1 1 1 1 1 1 1 1 1
1 0 0 2 0 0 2 0 0 2 0 0 2 0 0 1
1 0 1 1 2 1 2 1 1 2 1 2 1 1 0 1
1 2 1 2 2 2 0 2 2 0 2 2 2 1 2 1
1 0 0 0 0 1 2 0 0 2 1 0 0 0 0 1
1 0 1 2 0 2 0 1 1 0 2 0 2 1 0 1
1 0 1 2 0 2 0 1 1 0 2 0 2 1 0 1
1 0 0 0 0 1 2 0 0 2 1 0 0 0 0 1
1 0 1 2 2 2 0 0 0 0 2 2 2 1 0 1
1 0 1 1 0 1 0 1 1 0 1 0 1 1 0 1
1 0 0 2 0 0 0 0 0 0 0 0 2 0 0 1
1 1 1 1 1 1 1 1 1 1 1 1 1 1 1 1